1111111
1000011
10P0011
10C0011
1E00011
1111111
