11111111111111111111
100100010C010C010001
10010E00000010110001
10000C0100100C010001
101100010P0000000101
11111111111111111111
