1111111
1P00011
1000011
10C0011
1E00011
1111111
