
111111111111111111111111111111111111111111111111111111111111
111111111111111111111111111111111111111111111111111111111111
111111111111111111111111111111111111111111111111111111111111
111111111111111111111111111111111111111111111111111111111111
111111111111111111111111111111111111111111111111111111111111
111111111111111111111111111111111111111111111111111111111111
111111111111111111111111111111111111111111111111111111111111
1000000001000000001000000001000C0000100000000000000000100001
100000000100000000100000C001000000001000C00000000000000000C1
100000000100000000100000C001000000001000C00000000000000000C1
100000000100000000100000C001000000001000C00000000000000000C1
100C00000100000000000000000100000000100000000000000000111111
10000000000000000000000000010000000000000000010000C0001C0001
10000000000000C000000000000100000000C00000000100000000100001
100000000100000000100000000000000000000000000100000000000001
100000000100000000100C000000000000001000C0000100000000111111
1000000001000000001000000000000C0000100000000100000000100E01
100000000100000000100000000100000000100000000100C00000000EP1
100000000100000000100000C001000000001000C00010000000000000C1
111111111111111111111111111111111111111111111111111111111111
111111111111111111111111111111111111111111111111111111111111
111111111111111111111111111111111111111111111111111111111111
111111111111111111111111111111111111111111111111111111111111
111111111111111111111111111111111111111111111111111111111111
111111111111111111111111111111111111111111111111111111111111
111111111111111111111111111111111111111111111111111111111111
111111111111111111111111111111111111111111111111111111111111
111111111111111111111111111111111111111111111111111111111111
111111111111111111111111111111111111111111111111111111111111
111111111111111111111111111111111111111111111111111111111111
111111111111111111111111111111111111111111111111111111111111








