1111
1EC1
1001
1P01
1001
1001
1EC1
1001
1P01
1001
1001
1EC1
1001
1P01
1001
1001
1111